# Objects (KEYWORD1)
NextionComPort	KEYWORD1
NextionComponent	KEYWORD1

# Methods and Functions (KEYWORD2)
color656	KEYWORD2
update	KEYWORD2
debug	KEYWORD2
command	KEYWORD2
touch	KEYWORD2
release	KEYWORD2
value	KEYWORD2
text	KEYWORD2
attribute	KEYWORD2
attributeValue	KEYWORD2
attributeText	KEYWORD2
cls	KEYWORD2
line	KEYWORD2
rectangle	KEYWORD2
rectangleFilled	KEYWORD2
circle	KEYWORD2
circleFilled	KEYWORD2
picture	KEYWORD2
pictureCrop	KEYWORD2
pictureCropX	KEYWORD2

# Structures	(KEYWORD3)

# Constants (LITERAL1)